000100000000
000100111111
100100000000
000000000000
011001001101
001001001000
001000001000
001000001000
001111101011
100000001000
000111101000
000100000000